{
  "version": 1,
  "name": "hedge-his",
  "palette": [
    "#10121c",
    "#2c1e31",
    "#6b2643",
    "#ac2847",
    "#dfa06e",
    "#e8d282",
    "#f7f3b7",
    "#b0a7b8",
    "#7f708a",
    "#4a4b5b",
    "#21181b",
    "#5c8b93",
    "#3e3b65",
    "#89423f",
    "#d1b48c",
    "#eae4dd"
  ],
  "rows": [
    "11a919199911aa111a9a1a1191aa9911",
    "a1aa1c1aa911991a111a111a1a9991c1",
    "91a19111199999111a9a111a1191199a",
    "1111a1991a199c91a99a111911999c19",
    "11a91c11aa9999c199111aa119c1919c",
    "911a1919191a9999911a11111c1a1a19",
    "911a919911a911a19911991111a191c9",
    "1a19aa19cc9919999991a1991acc1a91",
    "1191191c99919bb9a11a99c9111aa199",
    "a91a9111199199911991191191a19911",
    "19a1a19a911991c9111a19a91aa1a111",
    "a199a911111a11a111a99a19aa111bc9",
    "19199911a911191911a1119191a19991",
    "91acc919aa1911991111a119c911999c",
    "111911919a1c9999199911cc9c9a1119",
    "99a1a191aa911119999119c19999a91a",
    "19a111a1919191a191aa9999c91a191a",
    "9991aa99991199aa111911119111c999",
    "9aa1111999a999a1191a19191c91aa99",
    "9a9c11111a19119911a11919119ca19b",
    "11c99c999a111191111aa99911919aa9",
    "191ac9191aa1a1a1911a99a1c9a1ca1a",
    "aa1191c9a1aaa11ca11919199119119a",
    "1a19999191a991111991a91911991911",
    "a1a1999c9999c91a1a19111c1199cc1a",
    "aaa191199c9c9c911111111111aa9911",
    "aa91111a1999cc911a111119911119c9",
    "11aa1a11aa1991999191aa19a191a19a",
    "c1a1119111a1199991991a1991a9999c",
    "1a91199911a91c91a99aaa991919911c",
    "199911991a11191a19a919911119119b",
    "a1a99a199911111a1a9991a111991991"
  ]
}
