{
  "version": 1,
  "name": "sidewalk-his",
  "palette": [
    "#10121c",
    "#2c1e31",
    "#6b2643",
    "#ac2847",
    "#dfa06e",
    "#e8d282",
    "#f7f3b7",
    "#b0a7b8",
    "#7f708a",
    "#4a4b5b",
    "#21181b",
    "#5c8b93",
    "#3e3b65",
    "#89423f",
    "#d1b48c",
    "#eae4dd"
  ],
  "rows": [
    "99999999999999999999999999999999",
    "98888888887888889888888788888888",
    "98888888888888889888888888888878",
    "98898888888889889898888888888888",
    "98888887888888889888888888888888",
    "98888888888888789888878888888888",
    "98988888888888889888888888788888",
    "98888888888888889888888888888888",
    "98888788888888889889888888888988",
    "98888888887888889888888788888888",
    "98888888888888889888888888888878",
    "98898888888889889898888888888888",
    "98888887888888889888888888888888",
    "98888888888888789888878888888888",
    "98988888888888889888888888788888",
    "98888888888888889888888888888888",
    "99999999999999999999999999999999",
    "98888888887888889888888788888888",
    "98888888888888889888888888888878",
    "98898888888889889898888888888888",
    "98888887888888889888888888888888",
    "98888888888888789888878888888888",
    "98988888888888889888888888788888",
    "98888888888888889888888888888888",
    "98888788888888889889888888888988",
    "98888888887888889888888788888888",
    "98888888888888889888888888888878",
    "98898888888889889898888888888888",
    "98888887888888889888888888888888",
    "98888888888888789888878888888888",
    "98988888888888889888888888788888",
    "98888888888888889888888888888888"
  ]
}
